lightning
level7
......
#....#
#...##
##..##
##.###
######
7 11 16
0